Host name = ชื่อระบุคอมพิวเตอร์
OS name = ชื่อระบบปฏิบัติการ
OS Uersion = การใช้ระบบปฏิบัติการ
OS Manufacturer = ผู้ผลิตระบบปฏิบัติการ
OS Configuration = การปรับแต่งและกำหนดค่่า
OS Build Type = ประเภทของรุ่นที่ติดตั้ง
Registered Owner = เจ้าของที่จดทะเบียน
Registered Orfganization = องค์กรที่จดทะเบียนแล้ว
Product ID = รหัสที่ไม่ซ้ำกันใช้ระบุผลิตภัณฑ์
Original Install Date = วันที่และเวลาที่ระบบปฏิบัติการ Windows ได้รับการติดตั้งบนคอมพิวเตอร์เป็นครั้งแรก
System Boot Time = ช่วงเวลาที่ระบบคอมพิวเตอร์ใช้ในการเริ่มต้นทำงาน
System Manufacturer =  ผู้ผลิตฮาร์ดแวร์ของคอมพิวเตอร์
System Model =ใช้จำลองข้อเท็จที่เกิดขึ้นในระบบ ประกอบด้วยแผนที่ภาพ
System Type = รูปแบบของสถาปัตยกรรมคอมพิวเตอร์
Processor<s> = สมองของคอมพิวเตอร์ ทำหน้าที่ประมวณผลและควบคุม

BIOS Uersion = รหัสที่บ่งบอกถึงชุดคำสั่งและฟังก์ชันการทำงานเฉพาะของ BIOS  
Windows Directory = บริการไดเรกทอรีที่พัฒนาโดย Microsoft สำหรับเครือข่าย Windows
System Directory = การจัดเก้บไฟล์
Boot Device = อุปกรณ์จัดเก็บข้อมูลที่คอมพิวเตอร์ใช้ในการเริ่มต้นระบบปฏิบัติการ 
System locale = การตั้งค่าภูมิภาคของระบบ
Input Locale = ตั้งค่าภาษาสำหรับแป้นพิมพ์
Time Locale = ตั้งค่ารูปแบบเวลา
Total zone = ทุกโซนหริอทั้งหมด
Total Physical Memory = หน่วยความจำแรมทั้งหมด
Available Physical Memory = หน่วยความจำแรมของปัจจุบัน
Uirtual Memory: Max Size: = ขนาดสูงสุดของความจำ
Uirtual Memory: Available: = หน่วยความจำเสมือนที่ยังเหลือ
Uirtual Memory: In Use: = หน่วยความจำที่ถูกใช้งานอยู่
Paga File Location<s> = ตำแหน่งไฟล์
Domain =โดเมนที่เชื่อมต่อคอมพิวเตอร์
Logon Server = เซิร์ฟเวอร์ที่ใช้ในการเช้าสู่ระบบ